34
11
01
03
05
32
|```````````````````````````````| 
|  P                            | 
|                               | 
|                               | 
|                               ||
|                               ||
|                               ||
|                               | 
|                               | 
|                               | 
|,,,,,,,,,,,,,,,,,,,,,,,,,,,,,,,| 